    F------7F------7
    I......LJ......I
    I*<7.^....^.F>*I
    I..I.L----J.I..I
    I.<J........L>.I
    I....F>  <7....I
    }-->.IcibpI.<--{
    I....L----J....I
    I.<7....e...F>.I
    I*.I.<---->.I.*I
    }>.V........V.<{
    I....^.F7.^....I
    I.<--J.LJ.L-->.I
    I..............I
    L--------------J

