     F-----M-M-----7
     I.....V.V.....I
     I*o.^.....^.o*I
     I...L-----J...I
     I.o.........o.I
     I....F>c<7....I
     }-->.IibpI.<--{
     I....L---J....I
     I.<7...e...F>.I
     I*.I.<-M->.I.*I
     }>.V...V...V.<{
     I....^...^....I
     I.<--W>.<W-->.I
     I.............I
     L-------------J

