    F------7F------7
    I......LJ......I
    I*<7.^....^.F>*I
    I..I.L----J.I..I
    I.<J...e....L>.I
    I....<---->....I
    }-->........<--{
    I....F>  <7....I
    I.<7.IcibpI.F>.I
    I*.I.L----J.I.*I
    }>.V........V.<{
    I....^.F7.^....I
    I.<--J.LJ.L-->.I
    I..............I
    L--------------J

